Enigma-3D
001 001 001 001 001 001 001 001 001 001 001 001 001 001 001 001 001 001 001 001 
001 004 003 001 001 137 001 137 003 003 003 003 003 003 001 003 003 003 003 001 
001 003 003 001 001 137 003 136 003 130 003 001 001 001 001 003 003 130 003 001 
001 130 003 001 001 137 136 003 001 003 003 001 003 003 129 003 003 003 003 001 
001 003 003 001 001 137 137 136 001 001 001 001 003 003 129 003 003 003 003 001 
001 001 001 001 001 137 001 003 001 003 003 001 003 003 001 001 136 001 001 001 
001 003 003 003 003 136 003 003 001 003 003 136 137 137 001 003 137 003 003 001 
001 003 003 003 003 003 003 003 001 003 003 001 003 003 001 003 137 003 130 001 
001 003 003 003 003 003 003 003 001 001 001 001 003 003 001 003 137 003 003 001 
001 129 129 001 001 001 003 003 001 003 003 001 136 001 001 001 001 001 001 001 
001 003 003 003 003 129 003 003 137 136 003 003 137 003 003 003 001 003 003 001 
001 003 130 003 003 129 003 003 001 130 001 003 137 003 003 003 001 003 130 001 
001 001 001 001 001 001 001 001 001 001 001 001 001 001 001 001 001 001 001 001 
introduce 17 2 to 18 11
introduce 18 11 to 17 2
introduce 9 11 to 18 11
introduce 18 11 to 9 11
introduce 18 7 to 2 11
introduce 2 11 to 18 7
introduce 1 3 to 9 2
introduce 9 2 to 1 3
end

