Enigma-3D
001 001 001 001 001 001 001 001 001 001 001 001 001 001 001 001 001 001 001 001 
001 003 003 003 129 003 003 003 003 003 003 003 003 003 003 003 003 003 003 001 
001 003 003 003 129 003 003 003 003 003 003 003 003 003 003 003 003 003 003 001 
001 003 003 003 129 003 003 003 003 003 130 003 003 003 130 003 003 003 003 001 
001 003 003 003 129 003 003 003 003 003 003 003 003 003 003 003 003 003 003 001
001 003 003 003 129 003 003 003 003 003 003 003 003 003 003 003 003 003 003 001
001 003 129 129 129 003 003 003 003 003 003 003 003 003 003 003 003 003 003 001
001 003 003 003 129 003 003 130 003 003 003 003 003 003 003 003 003 003 003 001
001 003 003 003 129 003 003 003 003 003 003 003 003 003 003 099 003 003 003 001 
001 003 003 003 129 003 003 003 003 003 003 003 003 003 099 098 099 003 003 001 
001 003 003 129 129 003 003 003 003 003 003 003 003 003 003 099 003 003 003 001 
001 003 003 129 129 003 003 003 003 003 003 003 003 003 003 003 003 003 003 001 
001 001 001 001 001 001 001 001 001 001 001 001 001 001 001 001 001 001 001 001 
introduce 7 7 to 14 7
introduce 14 7 to 7 7
introduce 14 7 to 14 3
introduce 14 3 to 14 7
end

