Enigma-3D
001 001 001 001 001 001 001 001 001 001 001 001 001 001 001 001 001 001 001 001 
001 003 003 003 003 003 003 003 003 003 003 003 003 003 003 003 003 003 003 001 
001 003 003 003 003 003 003 003 003 003 003 003 003 003 003 003 003 003 003 001 
001 003 003 003 003 003 003 130 003 003 003 003 003 003 003 129 003 003 003 001 
001 003 003 003 003 003 003 003 003 003 003 130 003 003 003 003 003 003 003 001 
001 003 003 003 003 003 003 003 003 003 003 003 003 003 003 003 003 003 003 001 
001 003 003 003 003 003 003 003 003 003 003 003 003 003 003 003 003 003 003 001 
001 003 003 003 003 003 003 003 003 003 003 003 003 003 003 003 099 003 003 001 
001 003 003 003 130 003 003 003 003 003 003 003 003 003 003 099 098 099 003 001 
001 003 003 003 003 003 003 003 003 003 003 003 003 130 003 003 099 003 003 001 
001 003 003 003 003 003 003 003 003 003 003 003 003 003 003 003 003 003 003 001 
001 003 003 003 003 003 003 003 003 003 003 003 003 003 003 003 003 003 003 001 
001 001 001 001 001 001 001 001 001 001 001 001 001 001 001 001 001 001 001 001 
introduce 4 8 to 7 3
introduce 4 8 to 11 4
introduce 4 8 to 13 9
introduce 7 3 to 4 8
introduce 7 3 to 11 4
introduce 7 3 to 13 9
introduce 11 4 to 4 8
introduce 11 4 to 7 3
introduce 11 4 to 13 9
introduce 13 9 to 4 8
introduce 13 9 to 7 3
introduce 13 9 to 11 4
end

